0000000000
0000000000
0000000000
0000000000
0000000000
0000000000
0111111110
0000000010
0111111110
0000000010