0000000000
0000000000
0000000000
0000000000
0000000000
0111111100
0000000000
0000000000
0111111111111111111111
0000000010