0000000000
0000000000
0000000000
0000000000
0000000000
0000000000
01111111111111111111110
0000000010
0111111110
0000000010